bdhA_del-1	ACGTCTCACATATGACTAGTgagacaactcccatgtgtgga
bdhA_del-2	AGTTCGAACTTAAGAGATCTtttgaaaccaaaaagaatccgcac
bdhA_del-3	AGGGTAATGCATGCCTGCAGacccgagtgcggattctttttggtttcaaaggattaccactcctataacttttga
bdhA_del-4	GGGGATCCTCTAGAGTCGACgaaaccagcagctcatcacc
bdhA_del-7	AGATCTCTTAAGTTCGAACTCGAGC
bdhA_del-8	CTGCAGGCATGCATTACCCT
test-bdhA_del-1	cgcttgagcagctggaggaa
test-bdhA_del-2	AGCTACACGCTGTCTTGCTTC
acoA_del-1	ACGTCTCACATATGACTAGTccgggctgttgaagaaaagc
acoA_del-2	AGTTCGAACTTAAGAGATCTtttgtgcgcctccttctatt
acoA_del-3	AGGGTAATGCATGCCTGCAGgtgaaccctaaatagaaggaggcgcacaaagagatggcgagagtcataagca
acoA_del-4	GGGGATCCTCTAGAGTCGACgccaagcaattcaagcgtga
acoA_del-7	AGATCTCTTAAGTTCGAACTCGAGC
acoA_del-8	CTGCAGGCATGCATTACCCT
test-acoA_del-1	agacaaaacgagacacacgtct
test-acoA_del-2	AGCTACACGCTGTCTTGCTTC
pta_del-1	ACGTCTCACATATGACTAGTtcatttcagcagctgtgattga
pta_del-2	AGTTCGAACTTAAGAGATCTtaaaattgaagacaatggcagctct
pta_del-3	AGGGTAATGCATGCCTGCAGggtcgagagctgccattgtcttcaattttaaataaaacctcctcaaaaagttaca
pta_del-4	GGGGATCCTCTAGAGTCGACcaagcgaaaggtgattgccg
pta_del-7	AGATCTCTTAAGTTCGAACTCGAGC
pta_del-8	CTGCAGGCATGCATTACCCT
test-pta_del-1	attaatgaaatatatggttatga
test-pta_del-2	AGCTACACGCTGTCTTGCTTC
ldh_del-1	ACGTCTCACATATGACTAGTcaggctatcactgcggtcaa
ldh_del-2	AGTTCGAACTTAAGAGATCTtaatcatccttccagggtatgt
ldh_del-3	AGGGTAATGCATGCCTGCAGaaagagaaacataccctggaaggatgattaccgcaactttagagtaaagggc
ldh_del-4	GGGGATCCTCTAGAGTCGACggaaaagcgctttgaaggca
ldh_del-7	AGATCTCTTAAGTTCGAACTCGAGC
ldh_del-8	CTGCAGGCATGCATTACCCT
test-ldh_del-1	ttcttttttgttcataaatcagaca
test-ldh_del-2	AGCTACACGCTGTCTTGCTTC
alsSD_P43_sub-1	ACGTCTCACATATGACTAGTgctcacgctctgcaaattcc
alsSD_P43_sub-2	tataaaaggaggaattcaaattgacaaaagcaacaaaagaaca
alsSD_P43_sub-3	AGGGTAATGCATGCCTGCAGtccgctccgtccgcgctgtttcccatatgctgataagtttcactatacactct
alsSD_P43_sub-4	GGGGATCCTCTAGAGTCGACtgttcatgtacctgcatcactct
alsSD_P43_sub-7	AGATCTCTTAAGTTCGAACTCGAGC
alsSD_P43_sub-8	CTGCAGGCATGCATTACCCT
alsSD_P43_sub-5	tttgaattcctccttttataatggt
alsSD_P43_sub-6	AGTTCGAACTTAAGAGATCTgcatatgggaaacagcgcg
test-alsSD_P43_sub-1	ataccgcatcaatttttgcacct
test-alsSD_P43_sub-2	AGCTACACGCTGTCTTGCTTC
test-alsSD_P43_sub-3	tgatcatcgactgcattacgc
test-alsSD_P43_sub-4	tgttcatgtacctgcatcac
amyE::P43_budC_ins-1	ACGTCTCACATATGACTAGTactgccgttattcgctggat
amyE::P43_budC_ins-2	ccgcgctgtttcccatatgccaccgcccagcctaaacg
amyE::P43_budC_ins-3	AGGGTAATGCATGCCTGCAGTTGATtGACGGCGGGATGGTaTTTAACTAAatagcttctcgttcaggcagt
amyE::P43_budC_ins-4	GGGGATCCTCTAGAGTCGACcaatggggaagagaaccgct
amyE::P43_budC_ins-7	AGATCTCTTAAGTTCGAACTCGAGC
amyE::P43_budC_ins-8	CTGCAGGCATGCATTACCCT
amyE::P43_budC_ins-5	gcatatgggaaacagcgcg
amyE::P43_budC_ins-6	AGTTCGAACTTAAGAGATCTTTAGTTAAAtACCATCCCGCCGT
test-amyE::P43_budC_ins-1	ctcccactatgcatctgatgtgt
test-amyE::P43_budC_ins-2	AGCTACACGCTGTCTTGCTTC
test-amyE::P43_budC_ins-3	cggtttgaaaggaggaagcg
test-amyE::P43_budC_ins-4	tcattgatggtttctttcggt
